1111111111111111111111111111111111111111111111111
1000000000000000000000000000000000000000000000001
1000000000000000000000000000000000000000000300001
1001111111111111111111111111111000000011000000001
1001111111111111111111111111111000000011000000001
1000000110000030000000000000000000000011000000001
1000000110000000000000000000000000000011000000001
1000000110000111111111111111111111111111111111111
1110000110000111111111111111111111111111111111111
1110000110000110000000000000000000000000000000001
1000000110000110000000000000000000000000000000001
1000000110000000000000000000000000000000000000001
1000000110000000000000000000000000003000000000001
1000111111110000011111111000000000000000000000001
1000111111110030011111111000000000000000000000001
1000000110000000000000011111111111111111100000001
1000000110000000000000011111111111111111100000001
1000000110000000000000011000000000000000000000001
1000000110000000000000011000000000000000000000001
1000000000000000000000011000000000000000000000001
1000000000000000000000011000000000000000000000001
1000000111111111111111111111111111000000300000001
1000000111111111111111111111111111000000000000001
1000000000000000000000000000000110000000000000001
1000000000000000000000000000000110001111111111111
1000000000000110000000000000000110001111111111111
1000000000000110000000000300000110000000000000001
1000000000000110000000000000000110000000000000001
1000000000000110000000000000000110000000000000001
1111111111111111111111111111111111111111111112111