111111111111111111111111111111111111111111111111111111111
111111111111111111111111111111111111111111111111111111111
111111111111111111111111111111111111111111111111111111111
111111111111111111111111111111111111111111111111111111111
111111111111111111111111111111111111111111111111111111111
111110000000000000000000000000000000000000000000000011111
111110000000000000000000000000000000000000000003000011111
111110011111111111111111111111111110000000110000000011111
111110011111111111111111111111111110000000110000000011111
111110000001100000300000000000000000000000110000000011111
111110000001100000000000000000000000000000110000000011111
111110000001100001111111111111111111111111111111111111111
111111100001100001111111111111111111111111111111111111111
111111100001100001100000000000000000000000000000000011111
111110000001100001100000000000000000000000000000000011111
111110000001100000000000000000000000000000000000000011111
111110000001100000000000000000000000000030000000000011111
111110001111111100000111111110000000000000000000000011111
111110001111111100300111111110000000000000000000000011111
111110000001100000000000000111111111111111111000000011111
111110000001100000000000000111111111111111111000000011111
111110000001100000000000000110000000000000000000000011111
111110000001100000000000000110000000000000000000000011111
111110000000000000000000000110000000000000000000000011111
111110000000000000000000000110000000000000000000000011111
111110000001111111111111111111111111110000003000000011111
111110000001111111111111111111111111110000000000000011111
111110000000000000000000000000000001100000000000000011111
111110000000000000000000000000000001100011111111111111111
111110000000000001100000000000000001100011111111111111111
111110000000000001100000000003000001100000000000000011111
111110000000000001100000000000000001100000000000000011111
111110000000000001100000000000000001100000000000000011111
111111111111111111111111111111111111111111111111121111111
111111111111111111111111111111111111111111111111111111111
111111111111111111111111111111111111111111111111111111111
111111111111111111111111111111111111111111111111111111111
111111111111111111111111111111111111111111111111111111111