1111111111111111111111111111111111111111111111111
1000000000000000000000000000000000000000000000001
1000000000000000000000000000000000000000000000001
1000000000000000000000000000000000000000000000001
1000000110000000000000000000000000000000000000001
1000000110000000000000000000000000000000000000001
1000000110000000000000000000000000000000000000001
1000000110000000000011111111111111111111111111111
1000000110000000000011111111111111111111111111111
1000000110000000000000000000000000000000000000001
1000000110000000000000000000000000000000000000001
1000000110000000000000000000000000000000000000001
1000000110000000000000000000000000000000000000001
1000000110000000000000011000000000000000000000001
1000000110000000000000011000000000000000000000001
1000000110000000000000011000000000000000000000001
1000000110000000000000011000000000000000000000001
1000000110000000000000011000000000000000000000001
1000000110000000000000011000000000000000000000001
1000000000000000000000011000000000000000000000001
1000000000000000000000011000000000000000000000001
1000000111111111111111111111111111000000000000001
1000000111111111111111111111111111000000000000001
1000000000000000000000000000000110000000000000001
1000000000000000000000000000000110000000000000001
1000000000000000000000000000000110000000000000001
1000000000000000000000000000000110000000000000001
1000000000000000000000000000000110000000000000001
1000000000000000000000000000000110000000000000001
1111111111111111111111111111111111111111111112111